1 1 2 2 3 3 5 6 1
2 2 3 4 5 6 4 1 3
3 4 20 3 1 2 1 2 1
1 2 5 5 4 4 3 2 1
2 1 1 12 5 2 3 1 6
2 3 5 6 1 2 6 6 4
3 1 2 2 1 5 4 5 4
1 2 3 4 5 1 18 3 4
1 2 3 4 5 6 3 2 3
100