1 1 3 6 5 2 6 1 6
2 2 3 6 5 6 4 7 3
3 7 5 4 6 7 1 3 1
1 2 5 5 4 4 3 2 1
2 3 7 6 5 2 3 1 6
2 3 3 1 1 7 6 6 4
3 1 3 2 7 5 4 5 4
2 3 1 4 3 4 5 6 1
1 2 7 5 4 4 3 7 1
100